AED=Dirhamul Emiratelor Arabe
AUD=Dolar australian
BGN=Leva bulgareasca
BRL=Realul brazilian
CAD=Dolar canadian
CHF=Franc elvetian
CNY=Renminbi-ul chinezesc
CZK=Coroana ceha
DKK=Coroana daneza
EGP=Lira egipteana
EUR=Euro
GBP=Lira sterlina
HRK=Kuna croata
HUF=100 Forinti maghiari
INR=Rupia indiana
JPY=100 Yeni japonezi
KRW=100 Woni sud-coreeni
MDL=Leul moldovenesc
MXN=Peso-ul mexican
NOK=Coroana norvegiana
NZD=Dolarul neo-zeelandez
PLN=Zlotul polonez
RSD=Dinarul sarbesc
RUB=Rubla ruseasca
SEK=Coroana suedeza
THB=Bahtul thailandez
TRY=Lira turceasca
UAH=Hryvna ucraineana
USD=Dolar american
XAU=Gramul de aur
XDR=DST
ZAR=Randul sud-african
